"filename", "language", "C++", "C", "Batch", "Makefile", "XML", "comment", "blank", "total"
"c:\Users\elmar\Eclipse_Workspaces\arm_diploma\final_project\.launches\final_project.launch", "XML", 0, 0, 0, 0, 16, 0, 1, 17
"c:\Users\elmar\Eclipse_Workspaces\arm_diploma\final_project\Common_Macros.h", "C++", 11, 0, 0, 0, 0, 19, 11, 41
"c:\Users\elmar\Eclipse_Workspaces\arm_diploma\final_project\Compiler.h", "C++", 16, 0, 0, 0, 0, 26, 12, 54
"c:\Users\elmar\Eclipse_Workspaces\arm_diploma\final_project\Debug\final_project_linkInfo.xml", "XML", 0, 0, 0, 0, 3424, 0, 1, 3425
"c:\Users\elmar\Eclipse_Workspaces\arm_diploma\final_project\Debug\makefile", "Makefile", 0, 0, 0, 144, 0, 8, 19, 171
"c:\Users\elmar\Eclipse_Workspaces\arm_diploma\final_project\Debug\objects.mk", "Makefile", 0, 0, 0, 2, 0, 3, 4, 9
"c:\Users\elmar\Eclipse_Workspaces\arm_diploma\final_project\Debug\sources.mk", "Makefile", 0, 0, 0, 108, 0, 4, 4, 116
"c:\Users\elmar\Eclipse_Workspaces\arm_diploma\final_project\Debug\subdir_rules.mk", "Makefile", 0, 0, 0, 7, 0, 4, 5, 16
"c:\Users\elmar\Eclipse_Workspaces\arm_diploma\final_project\Debug\subdir_vars.mk", "Makefile", 0, 0, 0, 117, 0, 4, 11, 132
"c:\Users\elmar\Eclipse_Workspaces\arm_diploma\final_project\Det.c", "C", 0, 11, 0, 0, 0, 10, 5, 26
"c:\Users\elmar\Eclipse_Workspaces\arm_diploma\final_project\Det.h", "C++", 22, 0, 0, 0, 0, 21, 12, 55
"c:\Users\elmar\Eclipse_Workspaces\arm_diploma\final_project\Dio.c", "C", 0, 325, 0, 0, 0, 141, 33, 499
"c:\Users\elmar\Eclipse_Workspaces\arm_diploma\final_project\Dio.h", "C++", 81, 0, 0, 0, 0, 106, 49, 236
"c:\Users\elmar\Eclipse_Workspaces\arm_diploma\final_project\Dio_Cfg.h", "C++", 29, 0, 0, 0, 0, 26, 16, 71
"c:\Users\elmar\Eclipse_Workspaces\arm_diploma\final_project\Dio_PBcfg.c", "C", 0, 27, 0, 0, 0, 19, 7, 53
"c:\Users\elmar\Eclipse_Workspaces\arm_diploma\final_project\Gpt.c", "C", 0, 18, 0, 0, 0, 10, 3, 31
"c:\Users\elmar\Eclipse_Workspaces\arm_diploma\final_project\Gpt.h", "C++", 5, 0, 0, 0, 0, 24, 5, 34
"c:\Users\elmar\Eclipse_Workspaces\arm_diploma\final_project\Mcu.c", "C", 0, 23, 0, 0, 0, 14, 5, 42
"c:\Users\elmar\Eclipse_Workspaces\arm_diploma\final_project\Mcu.h", "C++", 22, 0, 0, 0, 0, 19, 13, 54
"c:\Users\elmar\Eclipse_Workspaces\arm_diploma\final_project\Platform_Types.h", "C++", 37, 0, 0, 0, 0, 33, 14, 84
"c:\Users\elmar\Eclipse_Workspaces\arm_diploma\final_project\Port.c", "C", 0, 1124, 0, 0, 0, 15, 19, 1158
"c:\Users\elmar\Eclipse_Workspaces\arm_diploma\final_project\Port.h", "C++", 91, 0, 0, 0, 0, 121, 42, 254
"c:\Users\elmar\Eclipse_Workspaces\arm_diploma\final_project\Port_Cfg.h", "C++", 13, 0, 0, 0, 0, 19, 11, 43
"c:\Users\elmar\Eclipse_Workspaces\arm_diploma\final_project\Port_PBcfg.c", "C", 0, 25, 0, 0, 0, 10, 2, 37
"c:\Users\elmar\Eclipse_Workspaces\arm_diploma\final_project\Port_Reg.h", "C++", 46, 0, 0, 0, 0, 15, 11, 72
"c:\Users\elmar\Eclipse_Workspaces\arm_diploma\final_project\Std_Types.h", "C++", 29, 0, 0, 0, 0, 25, 13, 67
"c:\Users\elmar\Eclipse_Workspaces\arm_diploma\final_project\SysTick.c", "C", 0, 45, 0, 0, 0, 44, 11, 100
"c:\Users\elmar\Eclipse_Workspaces\arm_diploma\final_project\SysTick.h", "C++", 25, 0, 0, 0, 0, 36, 10, 71
"c:\Users\elmar\Eclipse_Workspaces\arm_diploma\final_project\Systick_cfg.c", "C", 0, 3, 0, 0, 0, 6, 3, 12
"c:\Users\elmar\Eclipse_Workspaces\arm_diploma\final_project\Systick_cfg.h", "C++", 6, 0, 0, 0, 0, 6, 6, 18
"c:\Users\elmar\Eclipse_Workspaces\arm_diploma\final_project\UART.c", "C", 0, 194, 0, 0, 0, 53, 21, 268
"c:\Users\elmar\Eclipse_Workspaces\arm_diploma\final_project\UART.h", "C++", 50, 0, 0, 0, 0, 17, 16, 83
"c:\Users\elmar\Eclipse_Workspaces\arm_diploma\final_project\UART_Cfg.h", "C++", 5, 0, 0, 0, 0, 6, 5, 16
"c:\Users\elmar\Eclipse_Workspaces\arm_diploma\final_project\UART_PBcfg.c", "C", 0, 5, 0, 0, 0, 6, 8, 19
"c:\Users\elmar\Eclipse_Workspaces\arm_diploma\final_project\UART_reg.h", "C++", 29, 0, 0, 0, 0, 6, 9, 44
"c:\Users\elmar\Eclipse_Workspaces\arm_diploma\final_project\app.c", "C", 0, 19, 0, 0, 0, 21, 5, 45
"c:\Users\elmar\Eclipse_Workspaces\arm_diploma\final_project\app.h", "C++", 12, 0, 0, 0, 0, 10, 2, 24
"c:\Users\elmar\Eclipse_Workspaces\arm_diploma\final_project\button.c", "C", 0, 37, 0, 0, 0, 7, 4, 48
"c:\Users\elmar\Eclipse_Workspaces\arm_diploma\final_project\button.h", "C++", 19, 0, 0, 0, 0, 7, 7, 33
"c:\Users\elmar\Eclipse_Workspaces\arm_diploma\final_project\eeprom.c", "C", 0, 104, 0, 0, 0, 54, 48, 206
"c:\Users\elmar\Eclipse_Workspaces\arm_diploma\final_project\eeprom.h", "C++", 16, 0, 0, 0, 0, 7, 8, 31
"c:\Users\elmar\Eclipse_Workspaces\arm_diploma\final_project\led.c", "C", 0, 29, 0, 0, 0, 7, 4, 40
"c:\Users\elmar\Eclipse_Workspaces\arm_diploma\final_project\led.h", "C++", 11, 0, 0, 0, 0, 69, 9, 89
"c:\Users\elmar\Eclipse_Workspaces\arm_diploma\final_project\main.c", "C", 0, 10, 0, 0, 0, 3, 2, 15
"c:\Users\elmar\Eclipse_Workspaces\arm_diploma\final_project\scheduler.c", "C", 0, 49, 0, 0, 0, 0, 9, 58
"c:\Users\elmar\Eclipse_Workspaces\arm_diploma\final_project\scheduler.h", "C++", 16, 0, 0, 0, 0, 17, 16, 49
"c:\Users\elmar\Eclipse_Workspaces\arm_diploma\final_project\tm4c123gh6pm.cmd", "Batch", 0, 0, 38, 0, 0, 0, 8, 46
"c:\Users\elmar\Eclipse_Workspaces\arm_diploma\final_project\tm4c123gh6pm.h", "C++", 6804, 0, 0, 0, 0, 5054, 857, 12715
"c:\Users\elmar\Eclipse_Workspaces\arm_diploma\final_project\tm4c123gh6pm_startup_ccs.c", "C", 0, 195, 0, 0, 0, 97, 10, 302
"Total", "-", 7395, 2243, 38, 378, 3440, 6229, 1406, 21129